11111111111111111111111111
1CC0E000000C10000101000011
10C000000000000C0001000001
10000100000100010101000011
10CC01100C10001C0011011101
10001000101CC0010011000001
10000100000100010101000011
1CC0000P000C10000101000011
11111111111111111111111111
