111111111111111111
1CC0E000C10000101
10C00000C0000011
1000010001000101
10CC011C10001C01
1000100101CC0011
1000010001000101
1CC000P0C10000101
111111111111111111
