11111111111111111111
1C00000000C100001E01
10C00100000000100001
100001C0000100001011
10C00110C000C001C011
10001000C00100010011
100001000C0100001011
1C00000P000C10000101
11111111111111111111
