11111111111111111111
1C0000C0000E10000101
10C000000000000C0001
10000100000100010001
10CC001C0C10001C0011
100010001000C0010011
1000000000C100010011
1C0C000P000C10000101
11111111111111111111
