11111111111111111111
1C00000000C100001C01
10C000C000000000C001
10000100000100010011
10CC0010C010001C0011
100010000001C0001011
100000C0000100001011
1C00000P000C10000E01
11111111111111111111
