11111111111111111111
1C000C0000C100001C01
10C001000000000C0001
100001C0000100001011
10C00110C000C001C011
10001000C00100010011
100001000C0100001011
1C00000P000C10000E01
11111111111111111111
