11111111111111111111
1C00000000C100001C01
10C0000C0000000C0001
10000100000100010101
10CC0110C010001C0011
10000000101C00010011
100C0100000100001011
1C0000P000C10000E001
10000000000000000011
11111111111111111111
