11111111111111
1CC0E00C100101
10C0000C001011
10001000101011
10CC011C101011
10001001010011
10000100010001
1CC000P0C10011
11111111111111
